1111111
10000P1
1000001
1000001
1000001
10000E1
1111111