111111111111111111111111111
1110E0111111111011111111111
111101111111110P01111111111
111101111111110001111111111
1111011111C1110001111111111
111111111111111111111111111
