111111111111111111111111111
1111E0111111111111111111111
111111111111111P11111111111
111111111111111111111111111
