111111111111111111111111111
100000000000000000000000001
1000000000000000000000P00E1
10C000000010000000000000001
1111011011C1110001100000001
111111111111111111111111111