111111111111111111111111111
1000000000000000000000000E1
100000000000000000000000001
100000000000000000000000001
1000C00C0000000P00000000001
111111111111111111111111111
