111111111111111111111111111
1000000100000000000000000E1
100000010000000000000000001
100000010000000000000000001
1000C0010000000P00000000001
111111111111111111111111111
