111111111111111111111111111
1000000100000000000000000E1
1000C0000000000P00000000001
111111111111111111111111111
