1111111111111111111111
100P100000000000000001
1000100000000000000001
1101100000000000000001
1010000000000000000001
100000000000000000E001
1101111111000000000001
1010000001000000000001
10000000C1000000000001
1111111111111111111111
