1111111111111111111111
100P100000000000000001
1000100000000000000001
1101100000000000000001
1000000000000000011111
100000000000000001E001
1101111111000000011111
1000000001000000000001
10000000C1000000000001
1111111111111111111111
