11111111111111111111111111
1P0000000000E0000000000C01
1111100000C010000000000001
11111111111111111111111111